...............
.P.............
....###........
.....#..C......
...............
...............
...........----
...........----
---------------