...............
...P...........
...............
........C......
...............
...............
...............
...............
---------------
