...............
...............
...............
.....++.B......
...............
...............
...............
.P............F
---------------