.............................................
.............................................
....................C........................
.....++.B.....................#..............
.P................-----......................
.............................++..............
...........................-----.............
.....................................F.......
---------------------------------------------