.............................................
.............................................
....###.............C........................
.....#..C.....................#..............
.P................-----......................
.............................##..............
...........................-----.............
.....................................F.......
---------------------------------------------