...............
...............
....C..........
...+++.........
.P.............
...............
...............
........###.F..
---------------