.............................................
....................................C........
....................C........................
.+++++..C...................###..............
.P................-----......................
.............................................
...........................-----.............
........###........................F.........
---------------------------------------------