.............................................
.............................................
....................C........................
.....++.B.....................#..............
..................-----......................
.............................++..............
...........................-----.............
.P...................................F.......
---------------------------------------------