.............................................
.............................................
....................C........................
.....++.B.....................#..............
..................-----......................
.............................++..............
...........................-----.............
.P..........ZZ.......................F.......
---------------------------------------------