.............................................
.............................................
....###.............C........................
.....+..C.....................#..............
.P................-----......................
.............................++..............
...........................-----.............
.....................................F.......
---------------------------------------------